*,*, , , , , , , , , , , , , , , , , , 
*, , , , , , , , , , , , , , , , , , , 
 , , , , , , , , , , , , , , ,*, , , , 
 , , , , , , , , ,*, , , , ,*,*,*, , , 
 , , , , , , , ,*,*, , , , , ,*, , , , 
 , , , , , , ,*, , ,*, , , , , , , , , 
 , , , , , , , , , ,*, , , , , , , , , 
 , ,*, , , , , , , ,*, , , , , , , , , 
 , , ,*, , , , ,O, ,*, , , , , , , , , 
 , , , ,*, ,*, , , ,*, , , , , , , , , 
 , , , , , ,*, , , ,*, , , , , , , , , 
 , , , , , ,*,*,*,*,*, , , , , , , , , 
 , , , , ,*, , , , , , , , , , , , , , 
 , , , , , , , , , , , , , , , , , , , 
 , , , , , , , , , , , , , , , , , , , 
 , , , , , , , , , , , ,*, , , , , , , 
 , , ,*,*,*,*, , , , ,*, , , , , , , , 
 , , , , , , , , , ,*,*, ,*, , , , , , 
 , , , , , , , , , , ,*, ,*, , , , , , 
 , , , , , , , , ,*, , ,X, , , , , , , 